ver.1.1
步 閒 彥 氓 を追加

ver.1.1.1
防に關する熟語羣を追加。 （←關がでません）

ver1.2
かうぢよ 扣除
こつくわい 國會
曆に關する熟語羣を追加。
錄に關する熟語羣を追加。
綠に關する熟語羣を追加。
內と內に關する熟語羣を追加。
くわんきやう 環境
靖に關する熟語羣を追加。
蠟に關する熟語羣を追加。
祕と祕に關する熟語羣を追加。
ふつくわつ 復活
每に關する熟語羣を追加。
とうかう	投稿
がう・きやう 强
强に關する孰語を追加
同音漢字の書き換へ 「壓～回」まで

ver2.0
csvによる運用の開始。
（テストとして、くわんきやう→環境 などの單語を追加。）
branch csvでの作業を開始。

ver3.0
すんだら	濟んだら	名詞	
じっさい	實際	名詞	
くわんり	管理	名詞	
ないよう	內容	名詞	
せつてい	設定	名詞	
おわつた	終わつた	名詞	
じやうほう	情報	名詞	
きりかへ	切り替へ	名詞	
きりかへ	切替	名詞	
の追加

ver2.1
くわいめつ	潰滅	名詞	
くわいらん	潰亂	名詞	
けつくわい	決潰	名詞	
ぜんくわい	全潰	名詞	
たうくわい	倒潰	名詞	
ほうくわい	崩潰	名詞	
くわうさう	宏壯	名詞	
くわうだい	宏大	名詞	
こうほう	弘報	名詞	
くわうや	曠野	名詞	
くわうげふ	礦業	名詞	
くわうせき	礦石	名詞	
たんくわう	炭礦	名詞	
さうくわう	蒼惶	名詞	
くわくぜん	劃然	名詞	
くわくきてき	劃期的	名詞	
くくわく	區劃	名詞	
ぐわいくわく	外廓	名詞	
くわくだい	廓大	名詞	
りんくわく	輪廓	名詞	
いつくわくせんきん	一攫千金	名詞	
くわいくわつ	快濶	名詞	
かうくわん	交驩	名詞	
てうかんづ	鳥瞰圖	名詞	
かんすう	函數	名詞	
くんせい	燻製	名詞	
くんじよう	燻蒸	名詞	
けいせん	繫船	名詞	
けいさう	繫爭	名詞	
けいぞく	繫屬	名詞	
けいりう	繫留	名詞	
れんけい	連繫	名詞	
れんけい	聯繫	名詞	
しげき	刺戟	名詞	
かんけつ	間歇	名詞	
かんけつせん	間歇泉	名詞	
けつき	蹶起	名詞	
けつべつ	訣別	名詞	
けんそ	嶮岨	名詞	
けむそ	嶮岨	名詞	
れうけん	了簡	名詞	
れうけん	料簡	名詞	
けいけん	敬虔	名詞	
げんぜん	儼然	名詞	
くわんげんがく	管絃樂	名詞	
げんか	絃歌	名詞	
さんげん	三絃	名詞	
げんわく	眩惑	名詞	
こかつ	涸渇	名詞	
きんこ	禁錮	名詞	
らくご	落伍	名詞	
かうふん	昂奮	名詞	
かうふん	亢奮	名詞	
りこう	悧巧	名詞	
こういん	勾引	名詞	
さうこく	相剋	名詞	
げこくじやう	下剋上	名詞	
こんめい	昏迷	名詞	
こんぜん	渾然	名詞	
かうさ	交叉	名詞	
かうさてん	交叉點	名詞	
さんさろ	三叉路	名詞	
よんさろ	四叉路	名詞	
ごさろ	五叉路	名詞	
ろくさろ	六叉路	名詞	
ななさろ	七叉路	名詞	
はちさろ	八叉路	名詞	
ざし	坐視	名詞	
ざす	坐洲	名詞	
たんざ	端坐	名詞	
れんざ	連坐	名詞	
はさい	破摧	名詞	
さうめつ	剿滅	名詞	
せんさう	船艙	名詞	
せうさう	焦躁	名詞	
かいさく	開鑿	名詞	
くつさく	掘鑿	名詞	
さくがんき	鑿岩機	名詞	
さくさん	醋酸	名詞	
さんかう	讚仰	名詞	
さんぎゃう	讚仰	名詞	
さんぎやう	讚仰	名詞	
さんじ	讚辭	名詞	
さんたん	讃嘆	名詞	
さんび	讃美	名詞	
ぜつさん	絕讚	名詞	
さつすい	撒水	名詞	
さつぷ	撒布	名詞	
したい	屍體	名詞	
しよくじ	食餌	名詞	
しよくじ	食事	名詞	
しよくじれうはふ	食餌療法	名詞	
しよくじれうほふ	食餌療法	名詞	
しょくじれうはふ	食餌療法	名詞	
しょくじれうほふ	食餌療法	名詞	
しうしふ	蒐集	名詞	
しうか	蒐荷	名詞	
とくしふ	特輯	名詞	
しうらく	聚落	名詞	
いしやれう	慰藉料	名詞	
あんしやう	暗誦	名詞	
ぎんしやう	吟誦	名詞	
いしやう	衣裳	名詞	
しやうへき	障壁	名詞	
しやうへき	牆壁	名詞	
せんでき	洗滌	名詞	
せんでう	洗滌	名詞	
せんじやう	洗淨	名詞	
せんじゃう	洗淨	名詞	
しゆんさい	駿才	名詞	
しゅんさい	駿才	名詞	
しゆんそく	駿足	名詞	
しゅんそく	駿足	名詞	
いうしゆん	優駿	名詞	
じゆんぼく	醇朴	名詞	
じゅんぼく	醇朴	名詞	
はうじゆん	芳醇	名詞	
はうじゅん	芳醇	名詞	
じよじやう	抒情	名詞	
じよじ	敘事	名詞	
じょじ	敘事	名詞	
しようじよ	陞叙	名詞	
しょうじょ	陞叙	名詞	
かいきしよく	皆既蝕	名詞	
げつしよく	月蝕	名詞	
につしよく	日蝕	名詞	
しよくじん	蝕甚	名詞	
しんしよく	侵蝕	名詞	
しんしよく	浸蝕	名詞	
ふしよく	腐蝕	名詞	
しんとう	滲透	名詞	
しんたん	滲炭	名詞	
かんじん	肝腎	名詞	
しんじゆつ	鍼術	名詞	
じんもん	訊問	名詞	
ばつすい	抜萃	名詞	
きんせい	均齊	名詞	
せうか	銷夏	名詞	
せうきよ	銷卻	名詞	
せうきょ	銷卻	名詞	
せうちん	銷沈	名詞	
いせき	遺蹟	名詞	
きせき	奇蹟	名詞	
きうせき	舊蹟	名詞	
こせき	古蹟	名詞	
しせき	史蹟	名詞	
しゆせき	手蹟	名詞	
しゅせき	手蹟	名詞	
しんせき	眞蹟	名詞	
ひつせき	筆蹟	名詞	
せんえい	尖銳	名詞	
せんたん	尖端	名詞	
せんぺい	尖兵	名詞	
せんかう	銓衡	名詞	
ちうせん	抽籤	名詞	
せんだん	擅断	名詞	
せんじやう	煽情	名詞	
せんどう	煽動	名詞	
そすい	疏水	名詞	
そつう	疏通	名詞	
そうめい	聰明	名詞	
そめい	疏明	名詞	
そし	沮止	名詞	
そさう	沮喪	名詞	
そうがふ	綜合	名詞	
そうざい	惣菜	名詞	
ゆさうせん	油槽船	名詞	
しゆうそく	終熄	名詞	
そうせい	簇生	名詞	
ぞくせい	簇生	名詞	
すいたい	衰頽	名詞	
たいせい	頽勢	名詞	
たいはい	頽廢	名詞	
たいしよく	褪色	名詞	
たいしよく	退職	名詞	
たいふう	颱風	名詞	
たいとう	擡頭	名詞	
たふしふ	蹈襲	名詞	
ざつたふ	雜沓	名詞	
さんたん	讃歎	名詞	
たんぐわん	歎願	名詞	
だんばう	煖房	名詞	
だんろ	煖炉	名詞	
えいち	叡智	名詞	
きち	機智	名詞	
ちゑ	智慧	名詞	
ちのう	智能	名詞	
ちぼう	智謀	名詞	
むち	無智	名詞	
りち	理智	名詞	
しんちやう	伸暢	名詞	
しんちゃう	伸暢	名詞	
てちやう	手帖	名詞	
てちゃう	手帖	名詞	
いつちやう	一挺	名詞	
いつちゃう	一挺	名詞	
ふてふ	符牒	名詞	
ちゆうかい	註解	名詞	
ちゆうしやく	註釋	名詞	
ちゆうぶん	註文	名詞	
ちゆうもん	註文	名詞	
ていねい	叮嚀	名詞	
さうてい	裝釘	名詞	
ていちよう	鄭重	名詞	
こんてい	根柢	名詞	
ていしよく	觝觸	名詞	
ていはく	碇泊	名詞	
しちてんはつたう	七顚八倒	名詞	
しちてんはつたう	七顛八倒	名詞	
しちてんはつき	七顚八起	名詞	
しちてんはつき	七顛八起	名詞	
てんたう	顚倒	名詞	
てんとう	顛倒	名詞	
てんぷく	顚覆	名詞	
てんぷく	顛覆	名詞	
かうでん	香奠	名詞	
ちんでん	沈澱	名詞	
とぜつ	杜絕	名詞	
はいとく	悖徳	名詞	
ばいどく	黴毒	名詞	
はうき	放棄	名詞	
はうき	拋棄	名詞	
はうき	抛棄	名詞	
はうぶつせん	拋物線	名詞	
はうぶつせん	抛物線	名詞	
はうちやう	庖丁	名詞	
はうちゃう	庖丁	名詞	
はうたい	繃帶	名詞	
きはく	氣魄	名詞	
みやくはく	脈搏	名詞	
ばくろ	曝露	名詞	
くわつぱつ	活潑	名詞	
くわつはつ	活溌	名詞	
はんぱつ	反撥	名詞	
はつかう	醗酵	名詞	
はんき	叛旗	名詞	
はんぎやく	叛逆	名詞	
はんらん	叛亂	名詞	
りはん	離叛	名詞	
くわうはん	廣汎	名詞	
らくばん	落磐	名詞	
しはん	紫斑	名詞	
はんてん	斑點	名詞	
はんしよく	蕃殖	名詞	
ばんぞく	蕃族	名詞	
ひご	蜚語	名詞	
やひ	野鄙	名詞	
ひけん	鄙見	名詞	
ひご	鄙語	名詞	
ひれつ	鄙劣	名詞	
ひわい	鄙猥	名詞	
ふうくわうめいび	風光明媚	名詞	
ふうし	諷刺	名詞	
ふんさう	扮裝	名詞	
へうぜん	飄然	名詞	
たんぺん	短篇	名詞	
ちやうへん	長篇	名詞	
ちゃうへん	長篇	名詞	
へんづつう	偏頭痛	名詞	
ほさ	輔佐	名詞	
ほだう	輔導	名詞	
ほいく	哺育	名詞	
けふとうほ	橋頭堡	名詞	
ほるい	堡壘	名詞	
ほさう	鋪裝	名詞	
ほぼ	保姆	名詞	
ぼし	拇指	名詞	
ほうぢ	捧持	名詞	
しぼつ	死歿	名詞	
ぼつねん	歿年	名詞	
せんぼつ	戰歿	名詞	
びようぼつ	病歿	名詞	
けんま	研磨	名詞	
まめつ	磨滅	名詞	
まもう	磨耗	名詞	
れんま	練磨	名詞	
れんま	練磨	名詞	
れんま	鍊磨	名詞	
れんま	錬磨	名詞	
まうどう	妄動	名詞	
まうしふ	妄執	名詞	
まうさう	妄想	名詞	
まうねん	妄念	名詞	
めんか	棉花	名詞	
もさく	摸索	名詞	
こよう	雇傭	名詞	
ようかい	熔解	名詞	
ようかい	鎔解	名詞	
ようくわうろ	熔鑛爐	名詞	
ようくわうろ	鎔鑛爐	名詞	
ようがん	熔岩	名詞	
ようせつ	熔接	名詞	
あいよく	愛慾	名詞	
がうよく	强慾	名詞	
しきよく	色慾	名詞	
しよくよく	食慾	名詞	
せいよく	性慾	名詞	
たいよく	大慾	名詞	
ぶつよく	物慾	名詞	
むよく	無慾	名詞	
めいよよく	名譽慾	名詞	
めいよ	名譽	名詞	
ぎよらう	漁撈	名詞	
ぎょらう	漁撈	名詞	
ふらん	腐爛	名詞	
はらん	波瀾	名詞	
りこう	悧巧	名詞	
りえう	俚謠	名詞	
じようりう	蒸溜	名詞	
りういん	澑飮	名詞	
ぎりやう	伎倆	名詞	
ぎりゃう	伎倆	名詞	
しやりやう	車輛	名詞	
しゃりやう	車輛	名詞	
しゃりゃう	車輛	名詞	
しやりゃう	車輛	名詞	
しんりやく	侵掠	名詞	
りやくだつ	掠奪	名詞	
だつりやく	奪掠	名詞	
りやうかい	諒解	名詞	
りゃうかい	諒解	名詞	
りやうしよう	諒承	名詞	
りゃうしよう	諒承	名詞	
りゃうしょう	諒承	名詞	
ひれき	披瀝	名詞	
れんさう	聯想	名詞	
れんじゆ	聯珠	名詞	
れんじゅ	聯珠	名詞	
れんぱう	聯邦	名詞	
れんめい	聯盟	名詞	
れんらく	聯絡	名詞	
れんりつ	聯立	名詞	
しれん	試煉	名詞	
れんたん	煉炭	名詞	
れんにゆう	煉乳	名詞	
れんにゅう	煉乳	名詞	
くわんろく	貫祿	名詞	
わんきよく	彎曲	名詞	
わんきょく	彎曲	名詞	
わんにふ	彎入	名詞	
ゐしゆく	萎縮	名詞	
ゐしゅく	萎縮	名詞	
うぃしゆく	萎縮	名詞	
うぃしゅく	萎縮	名詞	
ゑんご	援護	名詞	
うぇんご	援護	名詞	
えむご	掩護	名詞	
ぎえんきん	義捐金	名詞	
ゑんち	苑地	名詞	
うぇんち	苑地	名詞	
りう	畱	名詞	
くわう	礦	名詞	
くゎう	礦	名詞	
くわう	惶	名詞	
くゎう	惶	名詞	
くわつ	濶	名詞	
ぜつ	絕	名詞	
よく	慾	名詞	
の追加

今後の豫定
焰
說